################################
#..............................#
#..............................#
#..............................#
#..............................#
#..............B...............#
#..............................#
#..............................#
#..............................#
#..............................#
#..............................#
#..............................#
#..............................#
#..............................#
#..............................#
#........P.....................#
#..............................#
#..............................#
#..............................#
#..............................#
#..............................#
################################